StartingTile: 10 10

WidthHeight: 17 17
 
   0 0 0 0 0 0 0 0 1 0 0 0 0 0 0 0 0
   0 0 0 0 0 0 1 1 1 1 1 0 0 0 0 0 0
   0 0 0 0 0 1 1 1 1 1 1 1 0 0 0 0 0
   0 0 0 0 1 1 1 1 1 1 1 1 1 0 0 0 0
   0 0 0 1 1 1 1 1 1 1 1 1 1 1 0 0 0
   0 0 0 1 1 1 1 1 2 1 1 1 1 1 0 0 0
   0 0 0 1 1 1 1 1 3 1 1 1 1 1 0 0 0
   0 0 0 1 1 2 1 1 1 1 1 2 1 1 0 0 0
   0 0 0 1 1 1 1 1 1 1 1 1 1 1 0 0 0
   0 0 0 1 1 1 1 1 1 1 1 1 1 1 0 0 0
   0 0 0 1 1 1 1 1 1 1 1 1 1 1 0 0 0
   0 0 0 0 1 1 1 1 1 1 1 1 1 0 0 0 0
   0 0 0 0 0 1 1 1 1 1 1 1 0 0 0 0 0
   0 0 0 0 0 0 1 1 1 1 1 0 0 0 0 0 0
   0 0 0 0 0 0 0 1 1 1 0 0 0 0 0 0 0
   0 0 0 0 0 0 0 0 1 0 0 0 0 0 0 0 0
   0 0 0 0 0 0 0 0 1 0 0 0 0 0 0 0 0

Collidables:
  15 15 15 15 15 15 15 15 0 15 15 15 15 15 15 15 15 
  15 15 15 15 15 15 0 0 0 0 0 15 15 15 15 15 15 
  15 15 15 15 15 0 0 0 0 0 0 0 15 15 15 15 15 
  15 15 15 15 0 0 0 0 0 0 0 0 0 15 15 15 15 
  15 15 15 0 0 0 0 0 0 0 0 0 0 0 15 15 15 
  15 15 15 0 0 0 0 0 15 0 0 0 0 0 15 15 15 
  15 15 15 0 0 0 0 0 15 0 0 0 0 0 15 15 15 
  15 15 15 0 0 15 0 0 0 0 0 15 0 0 15 15 15 
  15 15 15 0 0 0 0 0 0 0 0 0 0 0 15 15 15 
  15 15 15 0 0 0 0 0 0 0 0 0 0 0 15 15 15 
  15 15 15 0 0 0 0 0 0 0 0 0 0 0 15 15 15 
  15 15 15 15 0 0 0 0 0 0 0 0 0 15 15 15 15 
  15 15 15 15 15 0 0 0 0 0 0 0 15 15 15 15 15 
  15 15 15 15 15 15 0 0 0 0 0 15 15 15 15 15 15 
  15 15 15 15 15 15 15 0 0 0 15 15 15 15 15 15 15 
  15 15 15 15 15 15 15 15 0 15 15 15 15 15 15 15 15 
  15 15 15 15 15 15 15 15 0 15 15 15 15 15 15 15 15