Layers: 3

WidthHeight: 17 17

   2  2  2  2  2  2  2  2  2  2  2  2  2  2  2  2  2 
   2  2  0  0  0  0  0  0  0  0  0  0  0  0  0  2  2 
   2  2  2  0  0  0  0  0 7  0  0  0  0  0  2  2  2 
   2  2  1  0  0  0  0  0  0  0  0  0  0  0  1  2  2 
   2  2  1  0  0  0  0  0  0  0  0  0  0  0  1  2  2 
   2  2  1  0  0  0  0  0  0  0  0  0  0  0  1  2  2 
   2  2  1  0  0  0  0  0  0  0  0  0  0  0  1  2  2 
   2  2  1  0  0  0  0  0  0  0  0  0  0  0  1  2  2 
   2  2  1  0  0  0  0  0  0  0  0  0  0  0  1  2  2 
   2  2  1  0  0  0  0  0  0  0  0  0  0  0  1  2  2 
   2  2  1  0  0  0  0  0  0  0  0  0  0  0  1  2  2 
   2  2  2  0  0  0  0  0  0  0  0  0  0  0  2  2  2 
   2  2  2  2  0  0  0  0  0  0  0  0  0  2  2  2  2 
   2  2  2  2  2  0  0  0  0  0  0  0  2  2  2  2  2 
   2  2  2  2  2  2  0  0  0  0  0  2  2  2  2  2  2 
   2  2  2  2  2  2  2  0  0  0  2  2  2  2  2  2  2 
   2  2  2  2  2  2  2  2  0  2  2  2  2  2  2  2  2

Layer2:

  7 7 7 7 7 7 7 7 7 7 7 7 7 7 7 7 7 
  7 7 7 7 7 7 7 7  5 7 7 7 7 7 7 7 7 
  7 7 7 7  5 7  5 7 7 7  5 7  5 7 7 7 7 
  7 7 7 7 7 7 7 7  6 7 7 7 7 7 7 7 7 
  7 7 7 7 7 7 7 7  6 7 7 7 7 7 7 7 7 
  7 7 7  6  6  6  6  6  6  6  6  6  6  6 7 7 7 
  7 7 7  6 7  4 7 7  4 7 7  4 7  6 7 7 7 
  7 7 7  6 7 7 7 7 7 7 7 7 7  6 7 7 7 
  7 7 7  6 7 7 7 7 7 7 7 7 7  6 7 7 7 
  7 7 7  6 7  4 7 7  4 7 7  4 7  6 7 7 7 
  7 7 7  6 7 7 7 7 7 7 7 7 7  6 7 7 7 
  7 7 7  6  6  6 7  5 7  5 7  6  6  6 7 7 7 
  7 7 7 7 7  6 7 7 7 7 7  6 7 7 7 7 7 
  7 7 7 7 7  6  6  6  6  6  6  6 7 7 7 7 7 
  7 7 7 7 7 7 7 7  6 7 7 7 7 7 7 7 7 
  7 7 7 7 7 7 7 7  6 7 7 7 7 7 7 7 7 
  7 7 7 7 7 7 7 7  6 7 7 7 7 7 7 7 7

Layer3:

  7 7 7 7 7 7 7 7 7 7 7 7 7 7 7 7 7 
  7 7 7 7 7 7 7 7 7 7 7 7 7 7 7 7 7 
  7 7 7 7 7 7 7 7 7 7 7 7 7 7 7 7 7 
  7 7 7 7 7 7 7 7 7 7 7 7 7 7 7 7 7 
  7 7 7 7 7 7 7 7 7 7 7 7 7 7 7 7 7 
  7 7 7 7 7  5 7 7  5 7 7  5 7 7 7 7 7 
  7 7 7 7 7 7 7 7 7 7 7 7 7 7 7 7 7 
  7 7 7 7 7 7 7 7 7 7 7 7 7 7 7 7 7 
  7 7 7 7 7  5 7 7  5 7 7  5 7 7 7 7 7 
  7 7 7 7 7 7 7 7 7 7 7 7 7 7 7 7 7 
  7 7 7 7 7 7 7 7 7 7 7 7 7 7 7 7 7 
  7 7 7 7 7 7 7 7 7 7 7 7 7 7 7 7 7 
  7 7 7 7 7 7 7 7 7 7 7 7 7 7 7 7 7 
  7 7 7 7 7 7 7 7 7 7 7 7 7 7 7 7 7 
  7 7 7 7 7 7 7 7 7 7 7 7 7 7 7 7 7 
  7 7 7 7 7 7 7 7 7 7 7 7 7 7 7 7 7 
  7 7 7 7 7 7 7 7 7 7 7 7 7 7 7 7 7

Collidables:
15 15 15 15 15 15 15 15 15 15 15 15 15 15 15 15 15 
  15 15 0 0 0 0 0 0 15 0 0 0 0 0 0 15 15 
  15 15 15 0 15 0 15 0 0 0 15 0 15 0 15 15 15 
  15 15 15 0 0 0 0 0 0 0 0 0 0 0 15 15 15 
  15 15 15 0 0 0 0 0 0 0 0 0 0 0 15 15 15 
  15 15 15 0 0 0 0 0 0 0 0 0 0 0 15 15 15 
  15 15 15 0 0 15 0 0 15 0 0 15 0 0 15 15 15 
  15 15 15 0 0 0 0 0 0 0 0 0 0 0 15 15 15 
  15 15 15 0 0 0 0 0 0 0 0 0 0 0 15 15 15 
  15 15 15 0 0 15 0 0 15 0 0 15 0 0 15 15 15 
  15 15 15 0 0 0 0 0 0 0 0 0 0 0 15 15 15 
  15 15 15 0 0 0 0 15 0 15 0 0 0 0 15 15 15 
  15 15 15 15 0 0 0 0 0 0 0 0 0 15 15 15 15 
  15 15 15 15 15 0 0 0 0 0 0 0 15 15 15 15 15 
  15 15 15 15 15 15 0 0 0 0 0 15 15 15 15 15 15 
  15 15 15 15 15 15 15 0 0 0 15 15 15 15 15 15 15 
  15 15 15 15 15 15 15 15 0 15 15 15 15 15 15 15 15